Common terms - native translation
item - ting
colonist - kolonist
joy - fornøyelse (moro?)
chunk - klump
block - kloss
research - forskning
forbid - forby
unforbid - tillat
interact - arbeide / samhandle
equip - utrust
inspector pane - oversikt
install (prothesis) - installere (feste?)
home (area) - hjemme (hjemmeområde)
tab - trykk på [navn på knappen]
orbital trade beacon - handelsmerke			
stockpile zone - lagerområde
hen om personer/grupper av uspesifisert kjønn
manhunting - mannevonde
bills - bestillinger
butcher - slakt
click - klikk
mine - grave
deteriorate - bryte ned
cryptosleep - dvale
faction - gruppe (fraksjon? 'gruppe' brukes allerede om 'group' (mini faction) i spillet)
caravan - karavane
goodwill - velvilje
ancient - antikk
drugs - rusmidler
